0 1 1
2 0 19 A 19 19 B
11111111111111111112
11111111111111111111
11111111111111111111
11BBBBB1111111111111
11111111111111111111
11111111111111111111
11111111111111111111
11111111111111111111
111111111AA111111111
11111111111111111111
11711111111111111111
111111111AA111111111
111111111AA111111111
11111111111111111111
11111111111111111111
111111111AA111111111
111111111AA111111111
11111111111111111111
11111155555555511111
11111155555555511113