13 8 15
0
00000000000000000000
00000000000000000000
00000000000000000000
00000000000000000000
00000000000000000000
00011151111511110000
00011000000001110000
00011000000000111000
00011100011100111000
00011155517100111000
00011100511100100000
00000100555551100000
00000111551555000000
00000011555555000000
00000011100110000000
00000000000000000000
00000000000000000000
00000000000000000000
00000000000000000000
00000000000000000000