14 7 7
2 8 15 A 14 16 B
00000000000000000000
00000000000000000000
00000000000000000000
00000000000000000000
00000000000000000000
00000000000111000000
00000011100111000000
0001AA11111111111000
0001BB11100000031000
00010000000000011000
00010000000000011000
00010000000111111000
00011111000111000000
00001171000111000000
00000111000111113000
00000000000000000000
00000000000000000000
00000000000000000000
00000000000000000000
00000000000000000000