2 10 4
2 9 5 A 8 11 B
00000000000000000000
00000000000000000000
00000000000000000000
00000000000000000000
00000000000000000000
00000000000000000000
00000000000000000000
00000000011110011100
00011110011310017100
00011210011110011100
0001111AA1111BB11100
00011110011110000000
00000000000000000000
00000000000000000000
00000000000000000000
00000000000000000000
00000000000000000000
00000000000000000000
00000000000000000000
00000000000000000000