4 10 4
0
00000000000000000000
00000000000000000000
00000000000000000000
00000000000000000000
00000000000000000000
00000055555550000000
00000055555550000000
00011110000011100000
00011100000001100000
00011100000001100000
00011100111155555000
00011100111155555000
00000000171005515000
00000000111005555000
00000000000000000000
00000000000000000000
00000000000000000000
00000000000000000000
00000000000000000000
00000000000000000000