6 8 2
0
00000000000000000000
00000000000000000000
00000000000000000000
00000000000000000000
00000000000000000000
00000001111110000000
00000001001110000000
00000001001111100000
00111111000001111000
00000011100001171000
00000011100000111000
00000000100110000000
00000000111110000000
00000000111110000000
00000000011100000000
00000000000000000000
00000000000000000000
00000000000000000000
00000000000000000000
00000000000000000000