7 3 15
0
00000000000000000000
00000000000000000000
00000000000000111000
00000111111111111000
00001110000000111000
00000110000000110000
00000100011111100000
00000111111100100000
00000100011000100000
00001110000000100000
00001110000001100000
00001111111111100000
00001100000000100000
00001000000000100000
00001000000000110000
00011000000001110000
00011111111111100000
00017100000000000000
00001000000000000000
00000000000000000000